7 10
##########
.........#
########.#
#........#
#.########
#........#
########.#