9 10
##########
....##...#
#####..###
#...#..#.#
##########
#..#..#..#
#..#..####
#..#.....#
########.#