9 10
##########
....#....#
#####..###
#......#.#
##########
#..#..#..#
#..#..####
#..#.....#
########.#